[layer]
type=Tile Layer 1
data=
1,1,1,1,1,1,1,1,1,1,1,
0,1,0,0,0,0,0,0,0,1,0,
0,1,0,0,0,0,0,0,0,1,0,
0,1,0,1,1,1,1,1,0,1,0,
0,0,0,0,0,0,0,0,0,0,0,
0,0,0,0,0,0,0,0,0,0,0,
0,0,0,0,0,0,0,0,0,0,0,
0,0,0,0,0,0,0,0,0,0,0,
0,0,0,0,0,0,0,0,0,0,0,
0,0,0,0,0,0,0,0,0,0,0,
1,0,0,0,0,0,0,0,0,0,1.
[layer]
type=Tile Layer 2
data=
0,9,9,9,9,9,9,9,9,9,0,
0,11,0,0,0,0,0,0,0,11,0,
0,11,0,0,0,0,0,0,0,11,0,
0,9,0,9,9,9,9,9,0,9,0,
0,0,0,0,0,0,0,0,0,0,0,
0,0,0,0,0,0,0,0,0,0,0,
0,0,0,0,0,0,0,0,0,0,0,
0,0,0,0,0,0,0,0,0,0,0,
0,0,0,0,0,0,0,0,0,0,0,
0,0,0,0,0,0,0,0,0,0,0,
0,0,0,0,0,0,0,0,0,0,9.
